1 1 1 1 1 1 1 1 0 0 0 0 0 0 5
1 1 1 3 3 1 1 1 0 1 1 1 1 1 1
1 1 1 1 1 1 1 1 0 1 1 1 1 1 1
2 2 2 2 2 2 2 2 0 1 1 1 1 1 1
1 1 1 1 1 1 1 1 0 1 1 3 3 1 1
1 1 3 1 1 3 1 1 0 1 1 2 2 1 1
1 1 1 1 1 1 1 1 0 2 2 2 2 2 2
2 2 2 2 2 2 2 2 0 1 1 1 1 1 1
1 1 1 1 1 1 1 1 0 1 1 1 1 1 1
0 0 0 0 0 0 0 4 0 1 1 1 1 1 1